###############
# #           #
#             #
#             #
#             #
#             #
#             #
#             #
#             #
#             #
###############