###########
#  #      E
#  # M##  #
#  ### #  #
#  #   #  #
#  #   ## #
#  #   #  #
#  #   #  #
#         #
###########