###############
# #    M      #
#             #
#             #
#             #
#             #
#             #
#             #
#             #
#             E
###############